               #####            
          ###+#  =  ######      
         #  =###=# # =    ###   
         # #   # #   #  # #4 #  
         # = #    =## =   ##-#  
         # #  # ##    # ##   #  
  #++++++# ###     # #   # # #  
 # #+##++# #   # # #   #   # #  
 #-##  #+# #=##    ###   ##* #  
#   |_ #+#=#    ###   # #### #  
#   #  ##    #    #   ##     #  
 # #####  #=#= ##=##-#   #####  
 #  |  | #   # =   # #   # |  # 
  ###_#### #   # # # # ### #  # 
     #+++#   #   # # ###   #-#  
          #######    # |   #  # 
          #       #### #   #  # 
          # ####### |  #######  
          # #   ### #-#     #   
         ## #       # # #,#_#   
        # | #   ###-# #,_,  #   
         ## ## ##+# ##8#,# #    
        #    #   #7  | , #,#    
       #* ###### ## ## ##  #### 
        # #       #-########   #
       #  # # ##### ##     #   #
       # ##   # =      # = ###=#
       #    ###=### ## = #   = #
       ###  ##  #+# ##     #### 
      #_|   ##  #+# = #####     
       #####++##+++###          
                                

A: 18, 22
b: 22, 21
c: 27, 3
