 ######+###++########           
#      #   ##        #######    
#  ### # # ## # #### #  |   #   
#  #+#   # #  # #  # #  ### ##  
 ##### ### # #  #  | #    # | # 
 #  _ _# #   #  #  # #  # # ##  
 # # # # ########### #  # # ### 
#  # # #     |       #### #  | #
#  # # # ### #### ####  # ,# ## 
#  #_ _  # #⇨###   ##   #_,# | #
# ## ### # # | 3 #    ####←# ## 
# #  #   #  ####   ###     # _ #
# #  #   ##      ##    ###  #  #
# #######  ⇨####    ###   # ### 
# #   #+# #-#+######↑|  # #    #
# #   ### #  #  ,###=#### ###  #
# #       #  # # #   #8+#-##8## 
# #### ## ####   # ### ##  # #  
#      ##  6++##   ### ##  | #  
# ##      #++##+####-#-###### # 
 1+# # ## ##4⇩|6#    # # ↓ ↓ ↓*#
 ### # ##   ####  ##-# #-#-#-## 
#    #  ## ####  ###*# # # # #  
 ### ## ## #    # # ##-## # #   
#          # ####-#-#   #-#-### 
# ###### ### # |↑ ↕ ↕   ↕ ↕ ↓| #
#  # #   #   ####-#-#   #-#-### 
 # # # ###-#⏶⏶⏶+# # #=#=# # #   
#  # # #4  ⏴   ⏵+#+##   ##+#    
# ##-# ###-#   ####### #        
#        # ⇧   |⇩|⇩|⇩|⇩#        
 ########+#############         

{
	"portals": {
		"Ⅰ": {
			"position": [11, 28]
		},
		"Ⅱ": {
			"position": [12, 27],
			"destination": [10, 4, "level-05"]
		},
		"Ⅳ": {
			"position": [13, 27],
			"destination": [29, 20, "level-09"]
		},
		"Ⅴ": {
			"position": [14, 27],
			"destination": [16, 0, "level-04"]
		},
		"Ⅷ": {
			"position": [15, 28]
		}
	},
	"stairs": {
		"K": [1, 20],
		"L": [15, 10],
		"m": [11, 18],
		"n¹": [12, 20],
		"n²": [15, 20],
		"s": [22, 16],
		"t": [8, 28],
		"y": [28, 16]
	},
	"teleports": [
		[20, 22, 29, 19, "rare items"],
		[30, 20, 20, 20, "rare items"]
	],
	"pointsOfInterest": [
		[11, 28],
		[15, 28]
	]
}
